##################################################################################
#        #            #        #            #        #            #        #     #
#        #            #        #            #        #            #        #     #
#### ######### ###################################################################
#        #            #        #            #        #            #        #     #
#        #            #        #            #        #            #        #     #
#### ######### ############################################################### ###
#        #            #        #            #        #            #        #     #
#        #            #        #            #        #            #        #     #
#### ######### ############################################################### ###
#        #            #        #            #        #            #        #     #
#        #            #        #            #        #            #        #     #
#### ######### ############################################################### ###
#        #            #        #            #        #            #        #     #
#        #                     #            #        #            #        #     #
#### #####            #### #####     @      ##########            ##########     #
#        #            #        #            #        #            #        #     #
#                     #        #            #        #            #        #     #
##################################################################################